{
    "corpus_parts": [
        4837157112, 
        4867156457, 
        4831150203, 
        4884043805, 
        4789508295, 
        4902915445
    ]
}