{
    "corpus_parts": [
        4070492248, 
        4084527545, 
        4065814500, 
        4055818125, 
        4072521590, 
        4089787213
    ]
}