{
    "corpus_parts": [
        4663524746, 
        4685565197, 
        4665686117, 
        4699555078, 
        4667920269, 
        4703540661
    ]
}