{
    "corpus_parts": [
        4208153816, 
        4194959873, 
        4197458938, 
        4202927005, 
        4184436375, 
        4212241031
    ]
}