{
    "corpus_parts": [
        4732921810, 
        4769412795, 
        4767056706, 
        4737853854, 
        4748932389, 
        4783368453
    ]
}