{
    "corpus_parts": [
        6425837856,
        6430936448,
        6428380291,
        6438259482,
        6418905022,
        6445799605
    ]
}