{
    "corpus_parts": [
        6356143905,
        6346256628,
        6363366086,
        6370978056,
        6348758269,
        6378165009
    ]
}