{
    "corpus_parts": [
        4316466665, 
        4305439435, 
        4338794004, 
        4335971891, 
        4333127589, 
        4344383656
    ]
}