{
    "corpus_parts": [
        6594993106,
        6592509299,
        6608286036,
        6601653262,
        6615399887,
        6622908841
    ]
}