{
    "corpus_parts": [
        4275249104, 
        4280734032, 
        4296390458, 
        4291282971, 
        4286241452, 
        4301388423
    ]
}