{
    "corpus_parts": [
        4367955042, 
        4369728819, 
        4380565114, 
        4398644187, 
        4361341599, 
        4400488893
    ]
}