{
    "corpus_parts": [
        4147126933, 
        4131945842, 
        4142097211, 
        4129925621, 
        4149342781, 
        4151450897
    ]
}