{
    "corpus_parts": [
        6301901520,
        6304214774,
        6286176347,
        6292842075,
        6299282266,
        6306450303
    ]
}