{
    "corpus_parts": [
        6208364118,
        6211020087,
        6201641645,
        6220392766,
        6213462973,
        6227427317
    ]
}