{
    "corpus_parts": [
        6722770270,
        6717023580,
        6709801448,
        6720117676,
        6702124286,
        6730150803
    ]
}