{
    "corpus_parts": [
        6387066481,
        6384639491,
        6404056660,
        6389391176,
        6396625613,
        6411541555
    ]
}