{
    "corpus_parts": [
        6541561134,
        6548898101,
        6533944601,
        6518484109,
        6525937902,
        6551567557
    ]
}