{
    "corpus_parts": [
        5583553833, 
        5554649740, 
        5478131397, 
        5512683542, 
        5472812710, 
        5589153760
    ]
}