{
    "corpus_parts": [
        6491302100,
        6508605530,
        6498920011,
        6506042109,
        6487079614,
        6511184207
    ]
}