{
    "corpus_parts": [
        6679131521,
        6673466099,
        6686754535,
        6666862907,
        6676566287,
        6694281408
    ]
}