{
    "corpus_parts": [
        4442404666, 
        4416459291, 
        4421523860, 
        4428676973, 
        4411141566, 
        4447940234
    ]
}