{
    "corpus_parts": [
        4155750489, 
        4164613474, 
        4170254164, 
        4175638150, 
        4160449863, 
        4182297847
    ]
}