{
    "corpus_parts": [
        4975882200, 
        5139164154, 
        5100998695, 
        4999235778, 
        5044398877, 
        5183796212
    ]
}