{
    "corpus_parts": [
        6172481683,
        6169751748,
        6186646387,
        6179365928,
        6167191515,
        6194165309
    ]
}