{
    "corpus_parts": [
        5993827168, 
        6022765473, 
        6016601309, 
        6005707110, 
        6084839313, 
        6087304342
    ]
}