{
    "corpus_parts": [
        4601338737, 
        4603218802, 
        4624892756, 
        4605231077, 
        4607849654, 
        4640567487
    ]
}