{
    "corpus_parts": [
        4270100153, 
        4248630562, 
        4259599716, 
        4254299814, 
        4264911638, 
        4272521202
    ]
}