{
    "corpus_parts": [
        5921714696, 
        5959321176, 
        5978909027, 
        5974828420, 
        5956599404, 
        5987578286
    ]
}