{
    "corpus_parts": [
        4095074986, 
        4108551766, 
        4099788090, 
        4113351246, 
        4118284069, 
        4127905232
    ]
}