{
    "corpus_parts": [
        6453383698,
        6467692090,
        6473260491,
        6470513772,
        6460837646,
        6480005682
    ]
}