{
    "corpus_parts": [
        4539901514, 
        4522224574, 
        4547686429, 
        4541746926, 
        4516686245, 
        4579126884
    ]
}