{
    "corpus_parts": [
        6277773874,
        6269739651,
        6261296996,
        6263585880,
        6275491516,
        6279991066
    ]
}