{
    "corpus_parts": [
        6089728993, 
        6119045738, 
        6111433653, 
        6103510462, 
        6096862663, 
        6125850315
    ]
}