{
    "corpus_parts": [
        4496677366, 
        4480531162, 
        4485456749, 
        4507210702, 
        4502004877, 
        4509044498
    ]
}