{
    "corpus_parts": [
        4470047064, 
        4454692009, 
        4460841226, 
        4452865487, 
        4465357913, 
        4477241990
    ]
}