{
    "corpus_parts": [
        5625171596, 
        5614291475, 
        5664985156, 
        5658179381, 
        5617424798, 
        5733891018
    ]
}