{
    "corpus_parts": [
        6247941187,
        6253829226,
        6233429930,
        6241204958,
        6256282670,
        6258834818
    ]
}