{
    "corpus_parts": [
        5318273105, 
        5322223498, 
        5415987871, 
        5250267247, 
        5381207473, 
        5446082204
    ]
}