{
    "corpus_parts": [
        6630323571,
        6633599063,
        6636403068,
        6651052941,
        6643493631,
        6658972992
    ]
}