{
    "corpus_parts": [
        6337070802,
        6322378036,
        6308668470,
        6315300585,
        6329738634,
        6343873784
    ]
}