{
    "corpus_parts": [
        4233655976, 
        4238988911, 
        4228063076, 
        4241421229, 
        4222443661, 
        4243499632
    ]
}