{
    "corpus_parts": [
        4911217168, 
        4956123459, 
        4913496807, 
        4939068997, 
        4944802119, 
        4963082340
    ]
}