{
    "corpus_parts": [
        6308671713,
        6299272434,
        6306432732,
        6301876014,
        6304225103,
        6315305388
    ]
}