{
    "corpus_parts": [
        4632017314, 
        4634441003, 
        4658343293, 
        4618873167, 
        4630095973, 
        4663452218
    ]
}