{
    "corpus_parts": [
        6103524185, 
        6128291770, 
        6125864411, 
        6111416445, 
        6119044753, 
        6130629424
    ]
}