{
    "corpus_parts": [
        4728051905, 
        4735510498, 
        4755057523, 
        4806052012, 
        4789491787, 
        4811887501
    ]
}