{
    "corpus_parts": [
        4275070360, 
        4259613731, 
        4270105004, 
        4243632341, 
        4264905830, 
        4286231244
    ]
}