{
    "corpus_parts": [
        6384635235,
        6363357878,
        6370975512,
        6356143678,
        6378172015,
        6387065987
    ]
}