{
    "corpus_parts": [
        4210076682, 
        4228285370, 
        4217667402, 
        4233629493, 
        4212222095, 
        4241257526
    ]
}