{
    "corpus_parts": [
        6404053808,
        6396607240,
        6389368156,
        6418890573,
        6411547196,
        6425822211
    ]
}