{
    "corpus_parts": [
        6551579747,
        6554020007,
        6541612377,
        6548894425,
        6533953164,
        6560948446
    ]
}