{
    "corpus_parts": [
        4584696593, 
        4601393810, 
        4605257347, 
        4607755237, 
        4596072142, 
        4613192354
    ]
}