{
    "corpus_parts": [
        6470513603,
        6467718483,
        6479991923,
        6473259852,
        6487107660,
        6491304054
    ]
}