{
    "corpus_parts": [
        4065857968, 
        4072523249, 
        4060568074, 
        4079428691, 
        4055833991, 
        4084424429
    ]
}