{
    "corpus_parts": [
        5767720832, 
        5671712530, 
        5884076667, 
        5806399130, 
        5709266367, 
        5893616209
    ]
}