{
    "corpus_parts": [
        4480481888, 
        4477132705, 
        4496523074, 
        4470068843, 
        4507099045, 
        4511090839
    ]
}