{
    "corpus_parts": [
        4361271560, 
        4366178849, 
        4367989427, 
        4380570894, 
        4385906137, 
        4391507615
    ]
}