{
    "corpus_parts": [
        6445788043,
        6430916011,
        6453392106,
        6428376235,
        6438254910,
        6460847473
    ]
}