{
    "corpus_parts": [
        6643500866,
        6666846883,
        6636407123,
        6658970216,
        6651053823,
        6673446807
    ]
}