{
    "corpus_parts": [
        6021665939, 
        6087303267, 
        6089721172, 
        6084836981, 
        6016418094, 
        6096835054
    ]
}