{
    "corpus_parts": [
        5999913896, 
        6002360961, 
        5986851562, 
        5978613027, 
        5993028251, 
        6005311005
    ]
}