{
    "corpus_parts": [
        4715468425, 
        4697561666, 
        4699543467, 
        4665749205, 
        4703444039, 
        4720838779
    ]
}