{
    "corpus_parts": [
        4516723394, 
        4522243935, 
        4541782645, 
        4533259370, 
        4573639087, 
        4579255937
    ]
}