{
    "corpus_parts": [
        6583026944,
        6589960179,
        6592506908,
        6575499965,
        6568563133,
        6594990181
    ]
}