{
    "corpus_parts": [
        4416487923, 
        4396523076, 
        4398468966, 
        4400526734, 
        4421590813, 
        4426148032
    ]
}