{
    "corpus_parts": [
        6694278594,
        6686740278,
        6702124344,
        6679133113,
        6676575180,
        6709777862
    ]
}