{
    "corpus_parts": [
        5413836625, 
        5400660338, 
        5415981914, 
        5448321966, 
        5353898109, 
        5454599075
    ]
}