{
    "corpus_parts": [
        4824637224, 
        4831377352, 
        4890103160, 
        4837199412, 
        4860944910, 
        4919624437
    ]
}