{
    "corpus_parts": [
        6508584593,
        6518471875,
        6511171174,
        6506042376,
        6498898154,
        6525940165
    ]
}