{
    "corpus_parts": [
        4432538473, 
        4442430814, 
        4437653653, 
        4452943798, 
        4447927937, 
        4460690495
    ]
}