{
    "corpus_parts": [
        6227428307,
        6220393172,
        6211005253,
        6233484266,
        6213461710,
        6241202994
    ]
}