{
    "corpus_parts": [
        6322389202,
        6337066169,
        6343870619,
        6329761821,
        6346266942,
        6348752564
    ]
}