{
    "corpus_parts": [
        5583405401, 
        5512749114, 
        5621311311, 
        5505464062, 
        5626940505, 
        5653881864
    ]
}