{
    "corpus_parts": [
        4160354208, 
        4153392537, 
        4151534717, 
        4149356101, 
        4155516913, 
        4164714191
    ]
}