{
    "corpus_parts": [
        6275476369,
        6286182790,
        6269741467,
        6280005436,
        6277765819,
        6292837972
    ]
}