{
    "corpus_parts": [
        6615383344,
        6622933668,
        6601679319,
        6630318572,
        6608280045,
        6633626915
    ]
}