{
    "corpus_parts": [
        4184396849, 
        4170193250, 
        4189702284, 
        4182178829, 
        4175474471, 
        4197427538
    ]
}