{
    "corpus_parts": [
        5020993841, 
        5012119674, 
        5062812787, 
        4944933116, 
        4925938935, 
        5069504856
    ]
}