{
    "corpus_parts": [
        5956711175, 
        5934574665, 
        5964159251, 
        5959333166, 
        5942277859, 
        5973767029
    ]
}