{
    "corpus_parts": [
        4101598416, 
        4094948835, 
        4089700924, 
        4103370435, 
        4099656999, 
        4108487305
    ]
}