{
    "corpus_parts": [
        5096512353, 
        5076107067, 
        5083281220, 
        5212726325, 
        5114742854, 
        5228383195
    ]
}