{
    "corpus_parts": [
        5322058985, 
        5252650819, 
        5241494205, 
        5235127302, 
        5288891917, 
        5352110676
    ]
}