{
    "corpus_parts": [
        6137823936, 
        6152561778, 
        6145297003, 
        6160347954, 
        6167187269, 
        6169750180
    ]
}