{
    "corpus_parts": [
        6247918946,
        6253828387,
        6258858396,
        6256276524,
        6261291775,
        6263587902
    ]
}